MsgGoalFulfilled=This Stippelculture was destroyed successfully!|Congratulations!
MsgGoalUnfulfilled=There are %d Stippel!
MsgGoalConfigurating=The host is still configurating!
Score=Points
Won=Won!
Stippel=Stippel
random=random
set=manual spawnpoint
infqueens=Queen (infinitive)
stippelmenu=Stippelmenu
predefined=Predefined
set_start_number=Set Startnumber
set_start_point=Set Distribution
set_power=Set Power
set_speed=Set Speed
set_res=Set Resistance
set_breeding=Set Breeding
miffel=Miffel
moffs=Moffs
queen=Queen
kokons=Kokons
ibreed=instant Breed
finished=Finished!
yes=Yes
no=No
pleasewait=Placing kokons!|Please wait!
more=More
less=Less
ok=OK
place_random=Place Random
place_manual=Set Spawnpoint
place_predefined=Use predefined Placing
set_startpos=Setting Spawnpoint...
power=Power
factor=Factor
resistance=Resistance
no_breeding=no Breeding
AWARD_Projectile=played Rambo!
AWARD_Fire=was the firebug!
AWARD_Explosion=made a terrific atmosphere!
AWARD_Energy=let the current flow! 
AWARD_Bio=likes it green!