MsgGoalFulfilled=Diese Stippelkultur wurde erfolgreich vernichtet!|Glückwunsch!
MsgGoalUnfulfilled=Es gibt %d Stippel!
MsgGoalConfigurating=Es wird noch Eingestellt!
Score=Punkte
Won=Gewonnen!
Stippel=Stippel
random=zufällig
set=gesetzt
infqueens=Königin (unendlich)
stippelmenu=Stippelmenü
predefined=Voreinstellung
set_start_number=Startzahl ändern
set_start_point=Startpunkt ändern
set_power=Stärke ändern
set_speed=Geschwindigkeit ändern
set_res=Resistanz ändern
set_breeding=Vermehrung ändern
miffel=Miffel
moffs=Moffs
queen=Königin
kokons=Kokons
ibreed=sofort Brüten
finished=Fertig!
yes=Ja
no=Nein
pleasewait=Platzierung erfolgt!|Bitte Warten!
more=Mehr
less=Weniger
ok=OK
place_random=Zufällig setzen
place_manual=Spawnpunkt setzen
place_predefined=Voreinstellung benutzen
set_startpos=Startposition setzen...
power=Stärke
factor=Faktor
resistance=Resistanz
no_breeding=Keine Vermehrung
AWARD_Projectile=hat Rambo gespielt!
AWARD_Fire=war der Feuerteufel!
AWARD_Explosion=machte eine Bombenstimmung!
AWARD_Energy=ließ den Strom fließen!
AWARD_Bio=mochte es grün!